{
  "textures": [
    { "name": "stock1", "file": "resources/simple/stock1.tga" },
    { "name": "stock2", "file": "resources/simple/stock2.tga" },
    { "name": "stock3", "file": "resources/simple/stock3.tga" },
    { "name": "stock4", "file": "resources/simple/stock4.tga" }
  ],
  "blocks": [
    { "id": 2, "go_through": false, "faces": ["stock1", "stock2", "stock3", "stock4"] }
  ],
  "floor": "blue_floor",
  "map": [
    [2, 2, 2, 2, 2, 2, 2, 2, 2, 2],
    [2, 0, 0, 0, 0, 0, 0, 0, 0, 2],
    [2, 0, 0, 0, 0, 0, 0, 0, 0, 2],
    [2, 0, 0, 0, 0, 2, 2, 0, 0, 2],
    [2, 0, 0, 0, 0, 0, 0, 0, 0, 2],
    [2, 0, 2, 0, 0, 0, 0, 0, 0, 2],
    [2, 0, 0, 0, 0, 0, 0, 0, 0, 2],
    [2, 0, 0, 0, 0, 2, 0, 0, 0, 2],
    [2, 0, 0, 0, 0, 0, 0, 2, 0, 2],
    [2, 0, 0, 0, 0, 0, 0, 0, 0, 2],
    [2, 0, 0, 1, 0, 0, 0, 0, 0, 2],
    [2, 0, 0, 0, 0, 0, 0, 0, 0, 2],
    [2, 0, 0, 0, 0, 0, 0, 0, 0, 2],
    [2, 0, 0, 2, 0, 0, 0, 2, 0, 2],
    [2, 0, 0, 0, 0, 0, 0, 0, 0, 2],
    [2, 0, 0, 0, 0, 0, 0, 0, 0, 2],
    [2, 2, 2, 2, 2, 2, 2, 2, 2, 2]
  ]
}
